┌──────────────────────┬──┬──────┬────────────┬──────┬─┬────────┬┬────────────────┐
│                      │  │      │            │      │ │        ││                │
│  ┌──┐  ┌┬─────────┐  │  │      │            │      │ │        ││                │
│  │  │  ││         │  └──┘      │            │      │ │        ││                │
│  │  │  ││  ┌──────┤            │            │      │ │        ││                │
│  │  │  ││  └──────┘  ┌──┐      │            │      └─┘        ││      ┌─────────┤
│  │  │  ││            │  │      │            │                 ││      └─────────┤
│  │  │  ││   ┌────┐   │  │      │            │          ┌─┐    ││                │
│  │  │  ││   └────┘   │  │      │            │          │ │    ││                │
│     │  ││            │  │      │            │          │ │    │┼────────┐       │
├─────┴──┴┴───┬┬───┐   │  │      │            ├───────   │ │    │┼────────┘       │
│             ││   │   │  │      │            │          │ │    └┘                │
│             └┘   │   │  │      │            │    ┌┐    │ │                      │
│                  │   │  │      │            │    ││    │ ├────────────────      │
│      │      ┌┐   │   │  │      │            │    ││    │ │                      │
│      │    ┌─┴┴┐  │   │  │      │            │    ││    │ │      ┌─┐             │
│      │    │   │  │   │  │      │            │    ││    │ │      │ │             │
│      │    │   │  │   │  │      │            │    ││    │ │      │ ├──────────   │
│      │    │   │  │   │  │      └─┬───┬──────┘    ││    │ │      │ │             │
│      │    │   │  │   ├──┤        │   │           ││    └─┘      │ │             │
│      │    │   │  │   │┼┼│        │   │           ││             │ │      ───────┤
│      │    │   │  │   └──┘    │   │   │    ───┬───┴┴────┬───┐    │ │             │
│      │    └───┘  │           │   │   │       │         │   │    │ │             │
│      │           │    ┌──┐   │   │   │       │         │   │    │ ├─────────    │
│      └───────────┘    │  │   │   │   │   ┌┬──┘         │   │    │ │             │
│                       │  │   │   │   │   ││    ┌──┐    │   │    │ ├──────       │
│        ┌─────┐        │  │   │   │   │   ││    │  │    │   │    │ │             │
│        │     │        │  │   │   │   ├───┴┘    │  │    │   │    │ │             │
│        │     │        │  │   │   └───┘         │  │    │   │    │ │   ──────────┤
│        │     │        └──┘   │                 │  │    └───┘    │ │             │
│        └─────┘               │                 │  │             │ │             │
│                              │    ┌─────┐      │  │             │ │           X │
└──────────────────────────────┴────┴─────┴──────┴──┴─────────────┴─┴─────────────┘