┌───┬───┬──────────────┬───┬──────────┐
│   │   │              │   │          │
│   │   │              │   │          │
│   │   │              │   │          │
│   │   │    ┌───┐     │   │    ┌─┐   │
│   │   │    │   │     │   │    │ │   │
│   │   │    │   │     │   │    │ │   │
│   │   │    │   │     │   │    │ │   │
│   │   │    │   │     │   │    │ │   │
│   │   │    │   │     │   │    │ │   │
│   │   │    │   │     │   │    │ │   │
│   └───┘    │   │     │   │    │ │   │
│            │   │     └───┘    │ │   │
│            │   │              │ │   │
│            │   │              │ │ X │
└────────────┴───┴──────────────┴─┴───┘